11111111111111111111111111111111111111111
1111111111111111111111E111111111111111111
1000C000000000000C0000000000C00000C000001
10001111111111111111111111111111111110001
10000000000000000000000000000000000000001
10000C0000000000000000000000C000000000001
1000000000000000000C000000000000000000001
100000000000C0000000000000000000C00000001
100000C0000000000000C00000000000000000001
1P0000000000000000000000000000000000000C1
11111111111111111111111111111111111111111