111111
1E1011
111U11
1111P1
1C1111
111111