111111111111111
1E0C0000C0000C1
100000C00000001
1000000000000P1
11111111111111